"","geo_id","tract","tract_num","less10","10to19","20to29","30to39","40to59","60to89","90plus","total_outside","workedhome","total","avgcommute"
"1","08001007801","Census Tract 78.01, Adams County, Colorado",7801,18,513,404,490,182,129,167,1903,36,1939,"33"
"2","08001007802","Census Tract 78.02, Adams County, Colorado",7802,31,604,316,358,300,173,58,1840,6,1846,"30"
"3","08001007900","Census Tract 79, Adams County, Colorado",7900,118,481,881,492,319,131,128,2550,48,2598,"30"
"4","08001008000","Census Tract 80, Adams County, Colorado",8000,84,664,664,558,327,211,40,2548,62,2610,"30"
"5","08001008100","Census Tract 81, Adams County, Colorado",8100,60,232,116,62,34,25,0,529,33,562,"20"
"6","08001008200","Census Tract 82, Adams County, Colorado",8200,273,585,393,460,298,79,14,2102,105,2207,"24"
"7","08001008308","Census Tract 83.08, Adams County, Colorado",8308,50,657,317,533,291,185,74,2107,84,2191,"31"
"8","08001008309","Census Tract 83.09, Adams County, Colorado",8309,59,439,464,311,138,63,0,1474,28,1502,"24"
"9","08001008353","Census Tract 83.53, Adams County, Colorado",8353,187,817,701,971,547,153,193,3569,94,3663,"32"
"10","08001008401","Census Tract 84.01, Adams County, Colorado",8401,195,269,288,541,541,195,53,2082,152,2234,"34"
"11","08001008402","Census Tract 84.02, Adams County, Colorado",8402,286,313,193,382,556,310,81,2121,259,2380,"35"
"12","08001008505","Census Tract 85.05, Adams County, Colorado",8505,189,637,768,908,533,341,98,3474,160,3634,"33"
"13","08001008506","Census Tract 85.06, Adams County, Colorado",8506,309,815,476,733,396,165,91,2985,77,3062,"28"
"14","08001008507","Census Tract 85.07, Adams County, Colorado",8507,332,658,702,795,594,238,68,3387,147,3534,"28"
"15","08001008508","Census Tract 85.08, Adams County, Colorado",8508,90,442,549,788,743,234,0,2846,171,3017,"32"
"16","08001008523","Census Tract 85.23, Adams County, Colorado",8523,420,581,716,794,896,346,126,3879,312,4191,"32"
"17","08001008524","Census Tract 85.24, Adams County, Colorado",8524,169,859,968,938,1089,199,0,4222,212,4434,"30"
"18","08001008526","Census Tract 85.26, Adams County, Colorado",8526,307,678,626,613,797,186,65,3272,372,3644,"31"
"19","08001008529","Census Tract 85.29, Adams County, Colorado",8529,343,678,924,989,543,308,73,3858,286,4144,"30"
"20","08001008533","Census Tract 85.33, Adams County, Colorado",8533,130,860,914,1286,824,250,159,4423,211,4634,"33"
"21","08001008534","Census Tract 85.34, Adams County, Colorado",8534,175,590,597,631,341,135,50,2519,99,2618,"28"
"22","08001008535","Census Tract 85.35, Adams County, Colorado",8535,119,337,610,448,222,130,30,1896,85,1981,"28"
"23","08001008536","Census Tract 85.36, Adams County, Colorado",8536,59,253,392,311,289,77,23,1404,165,1569,"30"
"24","08001008537","Census Tract 85.37, Adams County, Colorado",8537,135,568,713,956,518,256,38,3184,111,3295,"31"
"25","08001008538","Census Tract 85.38, Adams County, Colorado",8538,245,418,787,762,539,219,16,2986,342,3328,"30"
"26","08001008539","Census Tract 85.39, Adams County, Colorado",8539,202,878,1541,1152,976,228,141,5118,114,5232,"32"
"27","08001008540","Census Tract 85.40, Adams County, Colorado",8540,164,439,940,905,1030,181,127,3786,297,4083,"33"
"28","08001008541","Census Tract 85.41, Adams County, Colorado",8541,27,232,363,760,624,258,9,2273,184,2457,"35"
"29","08001008542","Census Tract 85.42, Adams County, Colorado",8542,338,628,738,719,664,603,70,3760,331,4091,"32"
"30","08001008543","Census Tract 85.43, Adams County, Colorado",8543,516,662,685,925,549,162,74,3573,213,3786,"28"
"31","08001008544","Census Tract 85.44, Adams County, Colorado",8544,138,403,614,557,464,174,36,2386,182,2568,"30"
"32","08001008545","Census Tract 85.45, Adams County, Colorado",8545,240,946,691,842,761,129,26,3635,320,3955,"28"
"33","08001008546","Census Tract 85.46, Adams County, Colorado",8546,93,293,362,503,366,62,25,1704,72,1776,"30"
"34","08001008547","Census Tract 85.47, Adams County, Colorado",8547,135,376,394,437,335,229,13,1919,106,2025,"30"
"35","08001008548","Census Tract 85.48, Adams County, Colorado",8548,20,123,172,223,241,62,24,865,33,898,"35"
"36","08001008549","Census Tract 85.49, Adams County, Colorado",8549,70,345,479,553,390,240,65,2142,182,2324,"35"
"37","08001008550","Census Tract 85.50, Adams County, Colorado",8550,201,807,1246,721,826,173,88,4062,161,4223,"31"
"38","08001008551","Census Tract 85.51, Adams County, Colorado",8551,77,61,96,133,161,14,46,588,85,673,"35"
"39","08001008603","Census Tract 86.03, Adams County, Colorado",8603,132,223,110,181,123,22,8,799,48,847,"24"
"40","08001008604","Census Tract 86.04, Adams County, Colorado",8604,325,394,242,395,204,65,40,1665,133,1798,"25"
"41","08001008605","Census Tract 86.05, Adams County, Colorado",8605,244,455,292,376,182,58,36,1643,128,1771,"25"
"42","08001008606","Census Tract 86.06, Adams County, Colorado",8606,691,584,464,533,536,97,15,2920,163,3083,"24"
"43","08001008705","Census Tract 87.05, Adams County, Colorado",8705,250,716,434,507,96,10,14,2027,83,2110,"21"
"44","08001008706","Census Tract 87.06, Adams County, Colorado",8706,163,634,526,451,178,103,89,2144,0,2144,"27"
"45","08001008709","Census Tract 87.09, Adams County, Colorado",8709,311,774,431,728,244,230,122,2840,50,2890,"29"
"46","08001008801","Census Tract 88.01, Adams County, Colorado",8801,226,526,410,532,300,120,11,2125,36,2161,"26"
"47","08001008802","Census Tract 88.02, Adams County, Colorado",8802,135,476,456,471,169,153,40,1900,42,1942,"27"
"48","08001008901","Census Tract 89.01, Adams County, Colorado",8901,153,268,140,186,93,40,31,911,20,931,"25"
"49","08001009001","Census Tract 90.01, Adams County, Colorado",9001,98,450,544,370,196,53,26,1737,89,1826,"26"
"50","08001009002","Census Tract 90.02, Adams County, Colorado",9002,203,1098,1378,976,446,442,26,4569,85,4654,"28"
"51","08001009101","Census Tract 91.01, Adams County, Colorado",9101,99,784,529,621,228,58,49,2368,11,2379,"26"
"52","08001009103","Census Tract 91.03, Adams County, Colorado",9103,34,327,437,388,230,47,41,1504,54,1558,"28"
"53","08001009104","Census Tract 91.04, Adams County, Colorado",9104,147,634,775,821,417,258,74,3126,85,3211,"30"
"54","08001009202","Census Tract 92.02, Adams County, Colorado",9202,148,449,646,410,222,185,122,2182,61,2243,"30"
"55","08001009203","Census Tract 92.03, Adams County, Colorado",9203,192,589,484,542,96,20,16,1939,35,1974,"23"
"56","08001009204","Census Tract 92.04, Adams County, Colorado",9204,154,850,1093,1074,475,224,62,3932,41,3973,"30"
"57","08001009206","Census Tract 92.06, Adams County, Colorado",9206,67,278,179,280,172,114,14,1104,23,1127,"30"
"58","08001009207","Census Tract 92.07, Adams County, Colorado",9207,142,533,700,447,517,161,20,2520,81,2601,"29"
"59","08001009304","Census Tract 93.04, Adams County, Colorado",9304,250,849,649,365,442,146,67,2768,173,2941,"27"
"60","08001009306","Census Tract 93.06, Adams County, Colorado",9306,218,526,386,391,189,65,29,1804,89,1893,"24"
"61","08001009307","Census Tract 93.07, Adams County, Colorado",9307,193,558,468,361,214,121,47,1962,66,2028,"27"
"62","08001009308","Census Tract 93.08, Adams County, Colorado",9308,162,519,438,554,259,226,69,2227,52,2279,"30"
"63","08001009309","Census Tract 93.09, Adams County, Colorado",9309,76,580,461,220,360,86,38,1821,54,1875,"28"
"64","08001009310","Census Tract 93.10, Adams County, Colorado",9310,342,706,721,445,310,81,56,2661,42,2703,"24"
"65","08001009316","Census Tract 93.16, Adams County, Colorado",9316,268,570,797,603,355,342,42,2977,83,3060,"29"
"66","08001009318","Census Tract 93.18, Adams County, Colorado",9318,153,465,700,528,722,167,166,2901,0,2901,"34"
"67","08001009319","Census Tract 93.19, Adams County, Colorado",9319,40,360,300,281,166,57,32,1236,15,1251,"28"
"68","08001009320","Census Tract 93.20, Adams County, Colorado",9320,42,295,294,425,100,65,24,1245,62,1307,"28"
"69","08001009321","Census Tract 93.21, Adams County, Colorado",9321,66,470,420,308,292,116,47,1719,100,1819,"29"
"70","08001009322","Census Tract 93.22, Adams County, Colorado",9322,77,608,437,387,195,139,36,1879,79,1958,"29"
"71","08001009323","Census Tract 93.23, Adams County, Colorado",9323,225,496,426,382,318,117,33,1997,145,2142,"27"
"72","08001009325","Census Tract 93.25, Adams County, Colorado",9325,329,695,771,537,240,163,0,2735,91,2826,"24"
"73","08001009326","Census Tract 93.26, Adams County, Colorado",9326,55,310,315,259,277,45,16,1277,119,1396,"29"
"74","08001009327","Census Tract 93.27, Adams County, Colorado",9327,187,506,337,351,214,137,0,1732,88,1820,"25"
"75","08001009401","Census Tract 94.01, Adams County, Colorado",9401,83,645,806,522,267,79,73,2475,112,2587,"28"
"76","08001009406","Census Tract 94.06, Adams County, Colorado",9406,283,522,725,428,238,87,0,2283,71,2354,"23"
"77","08001009407","Census Tract 94.07, Adams County, Colorado",9407,124,749,679,418,521,110,51,2652,77,2729,"28"
"78","08001009408","Census Tract 94.08, Adams County, Colorado",9408,284,593,411,435,597,54,11,2385,192,2577,"25"
"79","08001009409","Census Tract 94.09, Adams County, Colorado",9409,119,710,564,528,372,125,22,2440,401,2841,"27"
"80","08001009410","Census Tract 94.10, Adams County, Colorado",9410,99,332,259,344,187,67,51,1339,148,1487,"30"
"81","08001009411","Census Tract 94.11, Adams County, Colorado",9411,169,452,308,376,216,32,14,1567,203,1770,"24"
"82","08001009501","Census Tract 95.01, Adams County, Colorado",9501,27,464,497,357,138,37,110,1630,38,1668,"33"
"83","08001009502","Census Tract 95.02, Adams County, Colorado",9502,101,789,449,410,137,139,36,2061,29,2090,"25"
"84","08001009553","Census Tract 95.53, Adams County, Colorado",9553,292,388,288,279,123,125,19,1514,34,1548,"25"
"85","08001009603","Census Tract 96.03, Adams County, Colorado",9603,137,1031,583,314,332,170,142,2709,45,2754,"28"
"86","08001009604","Census Tract 96.04, Adams County, Colorado",9604,246,718,538,318,208,53,19,2100,14,2114,"22"
"87","08001009606","Census Tract 96.06, Adams County, Colorado",9606,98,359,321,355,125,83,61,1402,36,1438,"30"
"88","08001009607","Census Tract 96.07, Adams County, Colorado",9607,115,807,399,633,208,114,98,2374,74,2448,"28"
"89","08001009608","Census Tract 96.08, Adams County, Colorado",9608,81,413,536,399,138,214,0,1781,120,1901,"27"
"90","08001009751","Census Tract 97.51, Adams County, Colorado",9751,121,644,406,325,171,157,99,1923,90,2013,"28"
"91","08001009752","Census Tract 97.52, Adams County, Colorado",9752,77,505,417,324,80,80,33,1516,35,1551,"27"
"92","08001015000","Census Tract 150, Adams County, Colorado",15000,91,154,289,276,128,23,103,1064,51,1115,"35"
"93","08001060000","Census Tract 600, Adams County, Colorado",60000,271,593,538,612,495,91,78,2678,277,2955,"29"
"94","08001060100","Census Tract 601, Adams County, Colorado",60100,305,772,707,795,698,156,45,3478,132,3610,"28"
"95","08001060200","Census Tract 602, Adams County, Colorado",60200,267,450,418,468,397,77,52,2129,103,2232,"28"
"96","08001061200","Census Tract 612, Adams County, Colorado",61200,27,172,210,205,178,35,39,866,65,931,"32"
"97","08001988700","Census Tract 9887, Adams County, Colorado",988700,0,0,0,0,0,0,0,0,0,0,NA
"98","08005004951","Census Tract 49.51, Arapahoe County, Colorado",4951,169,667,190,319,179,107,57,1688,111,1799,"27"
"99","08005004952","Census Tract 49.52, Arapahoe County, Colorado",4952,201,404,479,303,148,107,8,1650,141,1791,"25"
"100","08005005551","Census Tract 55.51, Arapahoe County, Colorado",5551,142,280,586,204,188,49,24,1473,142,1615,"26"
"101","08005005552","Census Tract 55.52, Arapahoe County, Colorado",5552,110,237,274,262,104,49,12,1048,43,1091,"26"
"102","08005005553","Census Tract 55.53, Arapahoe County, Colorado",5553,225,546,384,269,328,114,130,1996,53,2049,"33"
"103","08005005611","Census Tract 56.11, Arapahoe County, Colorado",5611,288,814,336,477,307,95,30,2347,220,2567,"25"
"104","08005005612","Census Tract 56.12, Arapahoe County, Colorado",5612,159,544,452,400,133,43,10,1741,91,1832,"23"
"105","08005005614","Census Tract 56.14, Arapahoe County, Colorado",5614,145,553,302,298,170,10,19,1497,164,1661,"23"
"106","08005005619","Census Tract 56.19, Arapahoe County, Colorado",5619,122,495,500,477,471,99,24,2188,257,2445,"28"
"107","08005005620","Census Tract 56.20, Arapahoe County, Colorado",5620,257,250,328,335,182,66,34,1452,71,1523,"28"
"108","08005005621","Census Tract 56.21, Arapahoe County, Colorado",5621,58,435,297,276,203,60,0,1329,261,1590,"25"
"109","08005005622","Census Tract 56.22, Arapahoe County, Colorado",5622,65,214,253,175,168,43,0,918,162,1080,"26"
"110","08005005623","Census Tract 56.23, Arapahoe County, Colorado",5623,291,483,469,419,331,116,29,2138,183,2321,"26"
"111","08005005624","Census Tract 56.24, Arapahoe County, Colorado",5624,153,207,183,165,109,20,25,862,106,968,"27"
"112","08005005625","Census Tract 56.25, Arapahoe County, Colorado",5625,192,490,195,394,102,49,0,1422,168,1590,"22"
"113","08005005626","Census Tract 56.26, Arapahoe County, Colorado",5626,220,603,406,203,213,107,9,1761,193,1954,"24"
"114","08005005627","Census Tract 56.27, Arapahoe County, Colorado",5627,176,581,466,256,294,74,51,1898,401,2299,"27"
"115","08005005628","Census Tract 56.28, Arapahoe County, Colorado",5628,266,1318,525,422,335,95,5,2966,195,3161,"21"
"116","08005005629","Census Tract 56.29, Arapahoe County, Colorado",5629,47,383,136,195,80,54,23,918,154,1072,"28"
"117","08005005630","Census Tract 56.30, Arapahoe County, Colorado",5630,266,821,791,323,328,78,43,2650,358,3008,"24"
"118","08005005631","Census Tract 56.31, Arapahoe County, Colorado",5631,117,373,399,293,260,100,61,1603,148,1751,"30"
"119","08005005632","Census Tract 56.32, Arapahoe County, Colorado",5632,270,405,333,218,220,51,9,1506,185,1691,"23"
"120","08005005633","Census Tract 56.33, Arapahoe County, Colorado",5633,125,519,338,362,217,16,0,1577,144,1721,"23"
"121","08005005634","Census Tract 56.34, Arapahoe County, Colorado",5634,115,410,224,306,232,48,0,1335,140,1475,"25"
"122","08005005635","Census Tract 56.35, Arapahoe County, Colorado",5635,164,476,581,377,338,51,0,1987,206,2193,"24"
"123","08005005636","Census Tract 56.36, Arapahoe County, Colorado",5636,40,290,187,96,36,11,0,660,143,803,"20"
"124","08005005700","Census Tract 57, Arapahoe County, Colorado",5700,182,672,521,447,191,61,43,2117,79,2196,"25"
"125","08005005800","Census Tract 58, Arapahoe County, Colorado",5800,94,297,522,185,223,11,8,1340,115,1455,"25"
"126","08005005951","Census Tract 59.51, Arapahoe County, Colorado",5951,203,693,400,367,293,195,15,2166,128,2294,"27"
"127","08005005952","Census Tract 59.52, Arapahoe County, Colorado",5952,131,392,401,493,97,27,14,1555,55,1610,"24"
"128","08005006000","Census Tract 60, Arapahoe County, Colorado",6000,233,224,503,172,176,10,49,1367,69,1436,"25"
"129","08005006100","Census Tract 61, Arapahoe County, Colorado",6100,201,319,349,447,112,19,72,1519,53,1572,"27"
"130","08005006200","Census Tract 62, Arapahoe County, Colorado",6200,244,302,550,301,171,40,0,1608,46,1654,"23"
"131","08005006300","Census Tract 63, Arapahoe County, Colorado",6300,148,330,300,385,164,11,29,1367,47,1414,"26"
"132","08005006400","Census Tract 64, Arapahoe County, Colorado",6400,289,512,391,354,201,25,82,1854,56,1910,"28"
"133","08005006501","Census Tract 65.01, Arapahoe County, Colorado",6501,263,299,355,295,106,20,0,1338,84,1422,"21"
"134","08005006502","Census Tract 65.02, Arapahoe County, Colorado",6502,243,502,395,404,209,92,88,1933,115,2048,"28"
"135","08005006601","Census Tract 66.01, Arapahoe County, Colorado",6601,479,697,698,547,456,86,20,2983,86,3069,"24"
"136","08005006603","Census Tract 66.03, Arapahoe County, Colorado",6603,145,431,329,364,188,99,22,1578,91,1669,"27"
"137","08005006604","Census Tract 66.04, Arapahoe County, Colorado",6604,388,757,421,449,146,31,14,2206,75,2281,"21"
"138","08005006704","Census Tract 67.04, Arapahoe County, Colorado",6704,215,561,438,262,28,0,28,1532,223,1755,"20"
"139","08005006705","Census Tract 67.05, Arapahoe County, Colorado",6705,44,200,241,100,14,7,8,614,215,829,"22"
"140","08005006706","Census Tract 67.06, Arapahoe County, Colorado",6706,324,898,450,262,106,114,27,2181,395,2576,"21"
"141","08005006707","Census Tract 67.07, Arapahoe County, Colorado",6707,381,741,321,526,194,109,19,2291,336,2627,"23"
"142","08005006708","Census Tract 67.08, Arapahoe County, Colorado",6708,385,894,401,341,328,91,36,2476,305,2781,"24"
"143","08005006709","Census Tract 67.09, Arapahoe County, Colorado",6709,368,783,486,349,324,128,0,2438,218,2656,"23"
"144","08005006711","Census Tract 67.11, Arapahoe County, Colorado",6711,355,581,365,259,186,30,29,1805,193,1998,"22"
"145","08005006712","Census Tract 67.12, Arapahoe County, Colorado",6712,93,185,138,57,8,41,0,522,125,647,"20"
"146","08005006713","Census Tract 67.13, Arapahoe County, Colorado",6713,258,247,147,113,117,38,0,920,45,965,"20"
"147","08005006808","Census Tract 68.08, Arapahoe County, Colorado",6808,328,718,662,503,335,9,21,2576,334,2910,"23"
"148","08005006815","Census Tract 68.15, Arapahoe County, Colorado",6815,509,797,408,173,240,34,0,2161,209,2370,"18"
"149","08005006854","Census Tract 68.54, Arapahoe County, Colorado",6854,109,265,439,274,132,33,0,1252,125,1377,"24"
"150","08005006855","Census Tract 68.55, Arapahoe County, Colorado",6855,269,687,649,417,235,151,8,2416,325,2741,"24"
"151","08005006856","Census Tract 68.56, Arapahoe County, Colorado",6856,485,1382,1050,616,322,211,26,4092,139,4231,"22"
"152","08005006857","Census Tract 68.57, Arapahoe County, Colorado",6857,140,325,287,105,88,34,12,991,123,1114,"22"
"153","08005006858","Census Tract 68.58, Arapahoe County, Colorado",6858,290,909,623,345,182,163,42,2554,250,2804,"23"
"154","08005007101","Census Tract 71.01, Arapahoe County, Colorado",7101,181,280,399,280,664,414,70,2288,154,2442,"37"
"155","08005007103","Census Tract 71.03, Arapahoe County, Colorado",7103,6,78,227,145,248,45,38,787,126,913,"36"
"156","08005007104","Census Tract 71.04, Arapahoe County, Colorado",7104,587,560,359,524,317,76,40,2463,242,2705,"23"
"157","08005007105","Census Tract 71.05, Arapahoe County, Colorado",7105,72,538,463,403,606,140,57,2279,106,2385,"32"
"158","08005007106","Census Tract 71.06, Arapahoe County, Colorado",7106,182,429,761,746,442,257,45,2862,204,3066,"31"
"159","08005007107","Census Tract 71.07, Arapahoe County, Colorado",7107,271,571,997,930,536,153,69,3527,249,3776,"29"
"160","08005007201","Census Tract 72.01, Arapahoe County, Colorado",7201,8,405,314,478,233,97,115,1650,24,1674,"35"
"161","08005007202","Census Tract 72.02, Arapahoe County, Colorado",7202,92,310,345,543,284,105,112,1791,110,1901,"35"
"162","08005007301","Census Tract 73.01, Arapahoe County, Colorado",7301,73,299,244,222,157,40,55,1090,47,1137,"29"
"163","08005007302","Census Tract 73.02, Arapahoe County, Colorado",7302,196,438,423,626,284,158,215,2340,36,2376,"35"
"164","08005007400","Census Tract 74, Arapahoe County, Colorado",7400,67,619,415,602,420,213,21,2357,64,2421,"29"
"165","08005007500","Census Tract 75, Arapahoe County, Colorado",7500,57,276,313,226,189,90,42,1193,19,1212,"29"
"166","08005007600","Census Tract 76, Arapahoe County, Colorado",7600,113,315,315,425,198,48,44,1458,49,1507,"28"
"167","08005007702","Census Tract 77.02, Arapahoe County, Colorado",7702,81,350,497,355,256,68,97,1704,171,1875,"30"
"168","08005007703","Census Tract 77.03, Arapahoe County, Colorado",7703,115,315,469,648,195,96,67,1905,74,1979,"31"
"169","08005007704","Census Tract 77.04, Arapahoe County, Colorado",7704,121,386,815,455,361,107,180,2425,50,2475,"33"
"170","08005015100","Census Tract 151, Arapahoe County, Colorado",15100,179,348,290,265,141,22,33,1278,150,1428,"23"
"171","08005080000","Census Tract 800, Arapahoe County, Colorado",80000,109,328,339,374,246,62,68,1526,1,1527,"29"
"172","08005080100","Census Tract 801, Arapahoe County, Colorado",80100,171,503,636,382,118,164,75,2049,109,2158,"28"
"173","08005080200","Census Tract 802, Arapahoe County, Colorado",80200,264,587,892,567,211,135,37,2693,111,2804,"25"
"174","08005080300","Census Tract 803, Arapahoe County, Colorado",80300,168,667,1261,539,273,81,16,3005,221,3226,"24"
"175","08005080400","Census Tract 804, Arapahoe County, Colorado",80400,162,427,1103,565,321,92,49,2719,159,2878,"27"
"176","08005080500","Census Tract 805, Arapahoe County, Colorado",80500,120,586,581,393,194,21,0,1895,160,2055,"22"
"177","08005080600","Census Tract 806, Arapahoe County, Colorado",80600,139,411,710,427,129,72,13,1901,90,1991,"24"
"178","08005080700","Census Tract 807, Arapahoe County, Colorado",80700,200,727,605,535,275,182,60,2584,82,2666,"27"
"179","08005080800","Census Tract 808, Arapahoe County, Colorado",80800,78,425,434,250,98,89,41,1415,29,1444,"27"
"180","08005080900","Census Tract 809, Arapahoe County, Colorado",80900,138,468,593,309,414,169,33,2124,88,2212,"29"
"181","08005081000","Census Tract 810, Arapahoe County, Colorado",81000,167,627,671,414,374,72,12,2337,37,2374,"25"
"182","08005081100","Census Tract 811, Arapahoe County, Colorado",81100,253,494,834,565,541,263,26,2976,22,2998,"30"
"183","08005081200","Census Tract 812, Arapahoe County, Colorado",81200,337,572,423,455,228,89,38,2142,118,2260,"25"
"184","08005081300","Census Tract 813, Arapahoe County, Colorado",81300,37,284,255,483,236,144,75,1514,43,1557,"35"
"185","08005081400","Census Tract 814, Arapahoe County, Colorado",81400,27,562,474,306,129,67,44,1609,50,1659,"25"
"186","08005081500","Census Tract 815, Arapahoe County, Colorado",81500,30,153,187,112,59,0,0,541,78,619,"23"
"187","08005081600","Census Tract 816, Arapahoe County, Colorado",81600,130,580,638,431,332,103,61,2275,66,2341,"27"
"188","08005081700","Census Tract 817, Arapahoe County, Colorado",81700,132,231,340,309,208,157,13,1390,146,1536,"30"
"189","08005081800","Census Tract 818, Arapahoe County, Colorado",81800,100,544,596,614,355,157,155,2521,21,2542,"33"
"190","08005081900","Census Tract 819, Arapahoe County, Colorado",81900,218,750,464,540,303,221,156,2652,70,2722,"32"
"191","08005082000","Census Tract 820, Arapahoe County, Colorado",82000,68,616,554,439,320,111,32,2140,35,2175,"28"
"192","08005082100","Census Tract 821, Arapahoe County, Colorado",82100,169,809,780,777,488,203,66,3292,78,3370,"28"
"193","08005082200","Census Tract 822, Arapahoe County, Colorado",82200,81,995,741,527,402,210,0,2956,129,3085,"25"
"194","08005082300","Census Tract 823, Arapahoe County, Colorado",82300,75,434,564,535,154,108,33,1903,16,1919,"28"
"195","08005082400","Census Tract 824, Arapahoe County, Colorado",82400,92,581,453,492,264,189,26,2097,45,2142,"29"
"196","08005082500","Census Tract 825, Arapahoe County, Colorado",82500,53,256,305,302,183,62,4,1165,52,1217,"27"
"197","08005082600","Census Tract 826, Arapahoe County, Colorado",82600,16,668,933,649,329,119,68,2782,15,2797,"28"
"198","08005082700","Census Tract 827, Arapahoe County, Colorado",82700,204,247,378,312,270,266,30,1707,42,1749,"33"
"199","08005082800","Census Tract 828, Arapahoe County, Colorado",82800,83,509,696,677,373,129,37,2504,128,2632,"28"
"200","08005082900","Census Tract 829, Arapahoe County, Colorado",82900,106,302,512,663,495,250,59,2387,23,2410,"34"
"201","08005083000","Census Tract 830, Arapahoe County, Colorado",83000,42,455,670,476,181,81,49,1954,20,1974,"28"
"202","08005083100","Census Tract 831, Arapahoe County, Colorado",83100,76,659,951,1009,630,123,99,3547,205,3752,"30"
"203","08005083200","Census Tract 832, Arapahoe County, Colorado",83200,179,749,831,1638,855,275,82,4609,274,4883,"32"
"204","08005083300","Census Tract 833, Arapahoe County, Colorado",83300,122,455,684,619,493,140,23,2536,33,2569,"29"
"205","08005083400","Census Tract 834, Arapahoe County, Colorado",83400,198,607,877,1160,514,259,37,3652,327,3979,"30"
"206","08005083500","Census Tract 835, Arapahoe County, Colorado",83500,128,843,567,677,444,151,25,2835,92,2927,"28"
"207","08005083600","Census Tract 836, Arapahoe County, Colorado",83600,84,478,633,454,305,86,43,2083,54,2137,"29"
"208","08005083700","Census Tract 837, Arapahoe County, Colorado",83700,120,450,565,442,290,44,25,1936,174,2110,"27"
"209","08005083800","Census Tract 838, Arapahoe County, Colorado",83800,42,453,452,275,224,58,15,1519,62,1581,"27"
"210","08005083900","Census Tract 839, Arapahoe County, Colorado",83900,73,319,402,422,181,71,13,1481,166,1647,"27"
"211","08005084000","Census Tract 840, Arapahoe County, Colorado",84000,78,268,271,230,237,57,18,1159,33,1192,"28"
"212","08005084100","Census Tract 841, Arapahoe County, Colorado",84100,83,407,521,691,424,128,8,2262,57,2319,"30"
"213","08005084200","Census Tract 842, Arapahoe County, Colorado",84200,36,340,654,479,306,112,21,1948,75,2023,"30"
"214","08005084300","Census Tract 843, Arapahoe County, Colorado",84300,64,290,511,454,301,172,31,1823,130,1953,"31"
"215","08005084400","Census Tract 844, Arapahoe County, Colorado",84400,91,262,497,441,109,133,21,1554,102,1656,"29"
"216","08005084500","Census Tract 845, Arapahoe County, Colorado",84500,68,355,636,292,225,117,88,1781,45,1826,"35"
"217","08005084600","Census Tract 846, Arapahoe County, Colorado",84600,115,522,662,684,430,144,64,2621,168,2789,"31"
"218","08005084700","Census Tract 847, Arapahoe County, Colorado",84700,124,573,702,552,304,78,21,2354,98,2452,"26"
"219","08005084800","Census Tract 848, Arapahoe County, Colorado",84800,56,400,519,386,436,163,29,1989,80,2069,"32"
"220","08005084900","Census Tract 849, Arapahoe County, Colorado",84900,98,491,291,343,257,122,67,1669,180,1849,"31"
"221","08005085000","Census Tract 850, Arapahoe County, Colorado",85000,88,235,258,243,88,53,0,965,23,988,"24"
"222","08005085100","Census Tract 851, Arapahoe County, Colorado",85100,109,667,1017,716,380,134,25,3048,301,3349,"27"
"223","08005085200","Census Tract 852, Arapahoe County, Colorado",85200,55,307,366,258,204,32,32,1254,188,1442,"28"
"224","08005085300","Census Tract 853, Arapahoe County, Colorado",85300,162,139,329,286,206,116,33,1271,122,1393,"32"
"225","08005085400","Census Tract 854, Arapahoe County, Colorado",85400,151,366,632,600,455,181,25,2410,187,2597,"30"
"226","08005085500","Census Tract 855, Arapahoe County, Colorado",85500,73,606,645,739,438,119,72,2692,323,3015,"30"
"227","08005085600","Census Tract 856, Arapahoe County, Colorado",85600,111,374,419,460,216,88,24,1692,171,1863,"28"
"228","08005085700","Census Tract 857, Arapahoe County, Colorado",85700,110,381,668,538,401,236,100,2434,94,2528,"33"
"229","08005085800","Census Tract 858, Arapahoe County, Colorado",85800,57,151,226,156,222,60,7,879,37,916,"30"
"230","08005085900","Census Tract 859, Arapahoe County, Colorado",85900,103,234,579,555,389,152,47,2059,120,2179,"32"
"231","08005086000","Census Tract 860, Arapahoe County, Colorado",86000,144,433,1195,986,933,287,94,4072,393,4465,"32"
"232","08005086100","Census Tract 861, Arapahoe County, Colorado",86100,63,382,439,840,385,160,30,2299,211,2510,"31"
"233","08005086200","Census Tract 862, Arapahoe County, Colorado",86200,111,592,974,1000,441,198,51,3367,209,3576,"29"
"234","08005086300","Census Tract 863, Arapahoe County, Colorado",86300,194,897,494,430,324,86,44,2469,148,2617,"25"
"235","08005086400","Census Tract 864, Arapahoe County, Colorado",86400,66,182,332,211,123,15,9,938,195,1133,"26"
"236","08005086500","Census Tract 865, Arapahoe County, Colorado",86500,143,465,746,644,437,134,0,2569,224,2793,"28"
"237","08005086600","Census Tract 866, Arapahoe County, Colorado",86600,99,319,677,607,341,100,50,2193,322,2515,"31"
"238","08005086700","Census Tract 867, Arapahoe County, Colorado",86700,147,279,499,390,340,68,108,1831,168,1999,"34"
"239","08005086800","Census Tract 868, Arapahoe County, Colorado",86800,216,678,1235,947,232,115,70,3493,414,3907,"27"
"240","08005086900","Census Tract 869, Arapahoe County, Colorado",86900,237,564,409,405,183,39,42,1879,32,1911,"23"
"241","08005087000","Census Tract 870, Arapahoe County, Colorado",87000,327,617,1323,796,116,105,0,3284,53,3337,"23"
"242","08005087100","Census Tract 871, Arapahoe County, Colorado",87100,80,275,312,353,180,34,16,1250,79,1329,"27"
"243","08005087200","Census Tract 872, Arapahoe County, Colorado",87200,98,654,658,301,421,64,43,2239,210,2449,"28"
"244","08005087300","Census Tract 873, Arapahoe County, Colorado",87300,357,849,1053,995,435,228,134,4051,198,4249,"28"
"245","08013012101","Census Tract 121.01, Boulder County, Colorado",12101,334,1088,209,238,87,127,35,2118,430,2548,"20"
"246","08013012102","Census Tract 121.02, Boulder County, Colorado",12102,1029,1328,674,290,166,179,18,3684,643,4327,"18"
"247","08013012103","Census Tract 121.03, Boulder County, Colorado",12103,326,900,238,92,171,53,0,1780,392,2172,"18"
"248","08013012104","Census Tract 121.04, Boulder County, Colorado",12104,162,339,176,153,68,73,22,993,155,1148,"23"
"249","08013012105","Census Tract 121.05, Boulder County, Colorado",12105,455,1228,397,140,233,47,9,2509,567,3076,"18"
"250","08013012201","Census Tract 122.01, Boulder County, Colorado",12201,517,674,277,95,121,71,32,1787,293,2080,"20"
"251","08013012202","Census Tract 122.02, Boulder County, Colorado",12202,791,1824,459,146,231,67,91,3609,314,3923,"18"
"252","08013012203","Census Tract 122.03, Boulder County, Colorado",12203,988,1824,652,359,264,28,16,4131,443,4574,"17"
"253","08013012204","Census Tract 122.04, Boulder County, Colorado",12204,490,845,288,185,156,72,42,2078,286,2364,"19"
"254","08013012300","Census Tract 123, Boulder County, Colorado",12300,427,885,213,162,34,45,5,1771,499,2270,"16"
"255","08013012401","Census Tract 124.01, Boulder County, Colorado",12401,677,1000,448,48,282,14,17,2486,194,2680,"17"
"256","08013012501","Census Tract 125.01, Boulder County, Colorado",12501,173,728,208,162,130,46,11,1458,127,1585,"21"
"257","08013012505","Census Tract 125.05, Boulder County, Colorado",12505,276,815,326,204,143,44,44,1852,216,2068,"21"
"258","08013012507","Census Tract 125.07, Boulder County, Colorado",12507,209,1258,389,209,295,41,10,2411,270,2681,"20"
"259","08013012508","Census Tract 125.08, Boulder County, Colorado",12508,263,1035,292,120,153,70,27,1960,164,2124,"20"
"260","08013012509","Census Tract 125.09, Boulder County, Colorado",12509,83,654,298,136,225,41,0,1437,332,1769,"22"
"261","08013012510","Census Tract 125.10, Boulder County, Colorado",12510,223,797,580,258,407,18,65,2348,216,2564,"26"
"262","08013012511","Census Tract 125.11, Boulder County, Colorado",12511,410,1081,288,187,236,47,5,2254,402,2656,"19"
"263","08013012603","Census Tract 126.03, Boulder County, Colorado",12603,400,845,300,39,127,6,36,1753,157,1910,"18"
"264","08013012605","Census Tract 126.05, Boulder County, Colorado",12605,164,449,91,20,66,38,15,843,113,956,"19"
"265","08013012607","Census Tract 126.07, Boulder County, Colorado",12607,730,1008,394,349,69,20,0,2570,250,2820,"16"
"266","08013012608","Census Tract 126.08, Boulder County, Colorado",12608,278,825,270,77,56,17,15,1538,121,1659,"16"
"267","08013012701","Census Tract 127.01, Boulder County, Colorado",12701,419,1434,394,196,146,65,154,2808,547,3355,"24"
"268","08013012705","Census Tract 127.05, Boulder County, Colorado",12705,495,1006,302,283,162,54,27,2329,260,2589,"19"
"269","08013012707","Census Tract 127.07, Boulder County, Colorado",12707,65,364,116,45,66,11,35,702,153,855,"24"
"270","08013012708","Census Tract 127.08, Boulder County, Colorado",12708,339,974,480,116,185,62,14,2170,496,2666,"19"
"271","08013012709","Census Tract 127.09, Boulder County, Colorado",12709,65,377,204,89,46,49,6,836,168,1004,"22"
"272","08013012710","Census Tract 127.10, Boulder County, Colorado",12710,210,740,275,61,84,75,19,1464,215,1679,"19"
"273","08013012800","Census Tract 128, Boulder County, Colorado",12800,298,1300,2242,1025,710,200,68,5843,698,6541,"26"
"274","08013012903","Census Tract 129.03, Boulder County, Colorado",12903,60,286,407,115,105,38,22,1033,206,1239,"26"
"275","08013012904","Census Tract 129.04, Boulder County, Colorado",12904,148,612,878,472,320,100,66,2596,448,3044,"27"
"276","08013012905","Census Tract 129.05, Boulder County, Colorado",12905,126,304,324,344,65,22,0,1185,54,1239,"22"
"277","08013012907","Census Tract 129.07, Boulder County, Colorado",12907,211,391,420,288,80,115,23,1528,158,1686,"25"
"278","08013013003","Census Tract 130.03, Boulder County, Colorado",13003,157,686,1022,302,261,123,18,2569,433,3002,"24"
"279","08013013004","Census Tract 130.04, Boulder County, Colorado",13004,240,535,516,240,147,29,6,1713,213,1926,"21"
"280","08013013005","Census Tract 130.05, Boulder County, Colorado",13005,266,341,522,207,213,27,0,1576,237,1813,"22"
"281","08013013006","Census Tract 130.06, Boulder County, Colorado",13006,471,804,759,531,238,106,15,2924,470,3394,"22"
"282","08013013201","Census Tract 132.01, Boulder County, Colorado",13201,54,229,63,205,74,14,15,654,110,764,"27"
"283","08013013202","Census Tract 132.02, Boulder County, Colorado",13202,62,170,144,89,21,74,0,560,93,653,"26"
"284","08013013205","Census Tract 132.05, Boulder County, Colorado",13205,289,684,644,265,102,123,72,2179,436,2615,"24"
"285","08013013207","Census Tract 132.07, Boulder County, Colorado",13207,230,823,434,401,259,51,31,2229,164,2393,"24"
"286","08013013208","Census Tract 132.08, Boulder County, Colorado",13208,433,710,373,422,133,210,76,2357,220,2577,"26"
"287","08013013210","Census Tract 132.10, Boulder County, Colorado",13210,436,621,386,460,202,245,8,2358,148,2506,"25"
"288","08013013211","Census Tract 132.11, Boulder County, Colorado",13211,295,1065,730,542,171,77,0,2880,348,3228,"21"
"289","08013013212","Census Tract 132.12, Boulder County, Colorado",13212,419,560,446,247,217,87,35,2011,249,2260,"24"
"290","08013013213","Census Tract 132.13, Boulder County, Colorado",13213,703,1396,679,344,223,70,17,3432,524,3956,"19"
"291","08013013302","Census Tract 133.02, Boulder County, Colorado",13302,437,687,250,422,353,119,0,2268,256,2524,"24"
"292","08013013305","Census Tract 133.05, Boulder County, Colorado",13305,495,756,551,410,275,54,96,2637,245,2882,"24"
"293","08013013306","Census Tract 133.06, Boulder County, Colorado",13306,244,810,458,363,191,37,116,2219,86,2305,"25"
"294","08013013307","Census Tract 133.07, Boulder County, Colorado",13307,186,405,350,309,197,139,9,1595,96,1691,"27"
"295","08013013308","Census Tract 133.08, Boulder County, Colorado",13308,245,587,281,252,103,194,11,1673,81,1754,"24"
"296","08013013401","Census Tract 134.01, Boulder County, Colorado",13401,303,459,305,172,168,57,0,1464,160,1624,"20"
"297","08013013402","Census Tract 134.02, Boulder County, Colorado",13402,797,1210,908,326,310,246,44,3841,163,4004,"22"
"298","08013013503","Census Tract 135.03, Boulder County, Colorado",13503,557,734,485,536,252,84,55,2703,124,2827,"23"
"299","08013013505","Census Tract 135.05, Boulder County, Colorado",13505,76,629,432,359,242,120,0,1858,80,1938,"26"
"300","08013013506","Census Tract 135.06, Boulder County, Colorado",13506,237,482,405,268,259,215,19,1885,159,2044,"27"
"301","08013013507","Census Tract 135.07, Boulder County, Colorado",13507,229,360,223,309,199,39,39,1398,233,1631,"25"
"302","08013013508","Census Tract 135.08, Boulder County, Colorado",13508,472,1204,550,646,327,219,76,3494,189,3683,"26"
"303","08013013601","Census Tract 136.01, Boulder County, Colorado",13601,229,224,445,393,116,154,35,1596,499,2095,"29"
"304","08013013602","Census Tract 136.02, Boulder County, Colorado",13602,26,27,66,60,89,23,39,330,46,376,"40"
"305","08013013701","Census Tract 137.01, Boulder County, Colorado",13701,119,1026,736,404,332,104,43,2764,576,3340,"26"
"306","08013013702","Census Tract 137.02, Boulder County, Colorado",13702,160,367,448,653,948,316,119,3011,496,3507,"37"
"307","08013060600","Census Tract 606, Boulder County, Colorado",60600,539,801,915,404,319,125,17,3120,380,3500,"22"
"308","08013060700","Census Tract 607, Boulder County, Colorado",60700,256,457,408,164,161,11,0,1457,152,1609,"20"
"309","08013060800","Census Tract 608, Boulder County, Colorado",60800,521,1037,1157,708,398,62,53,3936,207,4143,"23"
"310","08013060900","Census Tract 609, Boulder County, Colorado",60900,317,625,863,305,193,49,73,2425,214,2639,"23"
"311","08013061300","Census Tract 613, Boulder County, Colorado",61300,193,584,252,319,161,45,20,1574,245,1819,"24"
"312","08013061400","Census Tract 614, Boulder County, Colorado",61400,135,532,482,298,202,41,56,1746,229,1975,"26"
"313","08014030000","Census Tract 300, Broomfield County, Colorado",30000,188,577,324,355,220,146,12,1822,51,1873,"25"
"314","08014030100","Census Tract 301, Broomfield County, Colorado",30100,174,270,274,241,167,45,10,1181,39,1220,"25"
"315","08014030200","Census Tract 302, Broomfield County, Colorado",30200,78,299,185,133,210,76,31,1012,37,1049,"31"
"316","08014030300","Census Tract 303, Broomfield County, Colorado",30300,218,464,245,279,269,199,25,1699,177,1876,"28"
"317","08014030400","Census Tract 304, Broomfield County, Colorado",30400,193,374,238,318,338,92,46,1599,256,1855,"30"
"318","08014030500","Census Tract 305, Broomfield County, Colorado",30500,148,525,519,672,517,106,166,2653,270,2923,"34"
"319","08014030600","Census Tract 306, Broomfield County, Colorado",30600,223,851,595,847,556,231,49,3352,72,3424,"29"
"320","08014030700","Census Tract 307, Broomfield County, Colorado",30700,89,201,298,456,359,87,55,1545,133,1678,"33"
"321","08014030800","Census Tract 308, Broomfield County, Colorado",30800,219,670,354,752,477,246,83,2801,184,2985,"31"
"322","08014030900","Census Tract 309, Broomfield County, Colorado",30900,352,655,476,445,370,182,25,2505,346,2851,"27"
"323","08014031000","Census Tract 310, Broomfield County, Colorado",31000,211,685,651,449,536,85,20,2637,248,2885,"27"
"324","08014031100","Census Tract 311, Broomfield County, Colorado",31100,433,688,632,499,365,128,0,2745,205,2950,"23"
"325","08014031200","Census Tract 312, Broomfield County, Colorado",31200,128,868,432,551,210,72,85,2346,175,2521,"27"
"326","08014031300","Census Tract 313, Broomfield County, Colorado",31300,34,332,239,239,142,84,0,1070,132,1202,"27"
"327","08014031400","Census Tract 314, Broomfield County, Colorado",31400,49,218,385,370,232,87,7,1348,298,1646,"28"
"328","08014980100","Census Tract 9801, Broomfield County, Colorado",980100,0,0,0,0,0,0,0,0,0,0,NA
"329","08014980200","Census Tract 9802, Broomfield County, Colorado",980200,0,0,0,0,0,0,0,0,0,0,NA
"330","08014980300","Census Tract 9803, Broomfield County, Colorado",980300,0,0,0,0,0,0,0,0,0,0,NA
"331","08031000102","Census Tract 1.02, Denver County, Colorado",102,95,501,612,345,238,18,18,1827,287,2114,"24"
"332","08031000201","Census Tract 2.01, Denver County, Colorado",201,184,733,486,292,180,36,20,1931,122,2053,"22"
"333","08031000202","Census Tract 2.02, Denver County, Colorado",202,204,699,478,271,118,90,22,1882,183,2065,"22"
"334","08031000301","Census Tract 3.01, Denver County, Colorado",301,204,827,840,611,336,54,37,2909,304,3213,"25"
"335","08031000302","Census Tract 3.02, Denver County, Colorado",302,211,685,581,674,289,38,0,2478,309,2787,"23"
"336","08031000303","Census Tract 3.03, Denver County, Colorado",303,195,805,760,512,380,91,14,2757,186,2943,"25"
"337","08031000401","Census Tract 4.01, Denver County, Colorado",401,190,440,500,214,122,129,10,1605,150,1755,"24"
"338","08031000402","Census Tract 4.02, Denver County, Colorado",402,296,868,680,612,309,95,14,2874,281,3155,"23"
"339","08031000501","Census Tract 5.01, Denver County, Colorado",501,69,309,271,262,144,16,6,1077,109,1186,"24"
"340","08031000502","Census Tract 5.02, Denver County, Colorado",502,197,843,751,667,255,142,56,2911,388,3299,"25"
"341","08031000600","Census Tract 6, Denver County, Colorado",600,174,688,365,321,142,81,14,1785,83,1868,"23"
"342","08031000701","Census Tract 7.01, Denver County, Colorado",701,90,755,344,212,90,116,37,1644,90,1734,"23"
"343","08031000702","Census Tract 7.02, Denver County, Colorado",702,224,712,444,416,228,151,8,2183,159,2342,"25"
"344","08031000800","Census Tract 8, Denver County, Colorado",800,1,108,29,29,40,22,0,229,0,229,"28"
"345","08031000902","Census Tract 9.02, Denver County, Colorado",902,103,700,699,790,222,117,25,2656,97,2753,"26"
"346","08031000903","Census Tract 9.03, Denver County, Colorado",903,240,691,466,582,345,240,44,2608,77,2685,"28"
"347","08031000904","Census Tract 9.04, Denver County, Colorado",904,168,321,377,571,134,238,14,1823,62,1885,"29"
"348","08031000905","Census Tract 9.05, Denver County, Colorado",905,137,530,388,587,246,102,10,2000,22,2022,"27"
"349","08031001000","Census Tract 10, Denver County, Colorado",1000,107,220,208,583,303,47,34,1502,27,1529,"30"
"350","08031001101","Census Tract 11.01, Denver County, Colorado",1101,108,349,327,182,212,77,21,1276,10,1286,"26"
"351","08031001102","Census Tract 11.02, Denver County, Colorado",1102,347,670,438,393,175,101,11,2135,233,2368,"22"
"352","08031001301","Census Tract 13.01, Denver County, Colorado",1301,208,707,531,598,129,148,15,2336,105,2441,"24"
"353","08031001302","Census Tract 13.02, Denver County, Colorado",1302,166,498,339,661,82,113,33,1892,45,1937,"26"
"354","08031001401","Census Tract 14.01, Denver County, Colorado",1401,186,578,608,807,305,187,70,2741,75,2816,"28"
"355","08031001402","Census Tract 14.02, Denver County, Colorado",1402,200,716,433,494,239,81,32,2195,14,2209,"25"
"356","08031001403","Census Tract 14.03, Denver County, Colorado",1403,36,506,599,441,199,93,11,1885,188,2073,"26"
"357","08031001500","Census Tract 15, Denver County, Colorado",1500,214,507,343,349,88,107,21,1629,90,1719,"24"
"358","08031001600","Census Tract 16, Denver County, Colorado",1600,745,2310,1350,1207,563,396,124,6695,733,7428,"24"
"359","08031001701","Census Tract 17.01, Denver County, Colorado",1701,450,965,816,480,216,35,0,2962,383,3345,"20"
"360","08031001702","Census Tract 17.02, Denver County, Colorado",1702,647,920,335,266,249,17,53,2487,430,2917,"19"
"361","08031001800","Census Tract 18, Denver County, Colorado",1800,218,724,386,257,182,123,17,1907,78,1985,"23"
"362","08031001901","Census Tract 19.01, Denver County, Colorado",1901,141,311,117,143,45,28,0,785,74,859,"20"
"363","08031001902","Census Tract 19.02, Denver County, Colorado",1902,87,112,21,40,21,10,0,291,30,321,"18"
"364","08031002000","Census Tract 20, Denver County, Colorado",2000,171,539,265,120,40,32,10,1177,189,1366,"19"
"365","08031002100","Census Tract 21, Denver County, Colorado",2100,246,887,949,833,306,0,104,3325,266,3591,"25"
"366","08031002300","Census Tract 23, Denver County, Colorado",2300,392,1165,656,776,181,61,32,3263,173,3436,"23"
"367","08031002402","Census Tract 24.02, Denver County, Colorado",2402,107,255,281,176,107,43,16,985,125,1110,"25"
"368","08031002403","Census Tract 24.03, Denver County, Colorado",2403,238,950,377,251,161,55,0,2032,89,2121,"19"
"369","08031002601","Census Tract 26.01, Denver County, Colorado",2601,226,555,515,288,305,56,62,2007,57,2064,"26"
"370","08031002602","Census Tract 26.02, Denver County, Colorado",2602,147,841,374,343,117,49,45,1916,220,2136,"23"
"371","08031002701","Census Tract 27.01, Denver County, Colorado",2701,412,1173,710,545,320,122,17,3299,357,3656,"22"
"372","08031002702","Census Tract 27.02, Denver County, Colorado",2702,427,1417,1232,741,364,109,34,4324,233,4557,"22"
"373","08031002703","Census Tract 27.03, Denver County, Colorado",2703,536,953,922,686,324,197,5,3623,275,3898,"24"
"374","08031002801","Census Tract 28.01, Denver County, Colorado",2801,242,634,361,402,188,23,21,1871,116,1987,"23"
"375","08031002802","Census Tract 28.02, Denver County, Colorado",2802,387,1215,579,612,246,14,38,3091,143,3234,"21"
"376","08031002803","Census Tract 28.03, Denver County, Colorado",2803,347,1070,688,459,343,93,0,3000,431,3431,"22"
"377","08031002901","Census Tract 29.01, Denver County, Colorado",2901,153,573,555,369,166,86,30,1932,287,2219,"25"
"378","08031002902","Census Tract 29.02, Denver County, Colorado",2902,157,1044,669,472,260,56,60,2718,288,3006,"24"
"379","08031003001","Census Tract 30.01, Denver County, Colorado",3001,386,1099,1273,509,245,45,8,3565,496,4061,"20"
"380","08031003002","Census Tract 30.02, Denver County, Colorado",3002,215,297,637,240,176,27,0,1592,181,1773,"23"
"381","08031003003","Census Tract 30.03, Denver County, Colorado",3003,123,567,270,221,180,7,94,1462,189,1651,"29"
"382","08031003004","Census Tract 30.04, Denver County, Colorado",3004,584,766,662,609,221,10,40,2892,384,3276,"21"
"383","08031003101","Census Tract 31.01, Denver County, Colorado",3101,81,230,235,246,84,44,10,930,72,1002,"26"
"384","08031003102","Census Tract 31.02, Denver County, Colorado",3102,307,592,275,300,104,69,0,1647,164,1811,"20"
"385","08031003201","Census Tract 32.01, Denver County, Colorado",3201,364,1202,748,798,244,90,30,3476,334,3810,"23"
"386","08031003202","Census Tract 32.02, Denver County, Colorado",3202,245,660,521,311,132,50,67,1986,250,2236,"23"
"387","08031003203","Census Tract 32.03, Denver County, Colorado",3203,159,755,210,182,115,9,17,1447,285,1732,"20"
"388","08031003300","Census Tract 33, Denver County, Colorado",3300,231,785,661,239,98,39,13,2066,171,2237,"20"
"389","08031003401","Census Tract 34.01, Denver County, Colorado",3401,183,455,269,204,102,42,14,1269,185,1454,"22"
"390","08031003402","Census Tract 34.02, Denver County, Colorado",3402,307,787,515,262,213,46,23,2153,459,2612,"22"
"391","08031003500","Census Tract 35, Denver County, Colorado",3500,284,763,703,566,238,181,0,2735,92,2827,"24"
"392","08031003601","Census Tract 36.01, Denver County, Colorado",3601,203,832,242,404,245,141,37,2104,257,2361,"25"
"393","08031003602","Census Tract 36.02, Denver County, Colorado",3602,86,599,591,467,271,129,52,2195,91,2286,"28"
"394","08031003603","Census Tract 36.03, Denver County, Colorado",3603,214,556,366,299,308,123,23,1889,194,2083,"26"
"395","08031003701","Census Tract 37.01, Denver County, Colorado",3701,190,734,565,374,207,45,0,2115,246,2361,"22"
"396","08031003702","Census Tract 37.02, Denver County, Colorado",3702,487,1140,694,362,305,41,11,3040,164,3204,"20"
"397","08031003703","Census Tract 37.03, Denver County, Colorado",3703,311,579,475,358,249,9,41,2022,180,2202,"23"
"398","08031003800","Census Tract 38, Denver County, Colorado",3800,327,1197,747,575,308,14,80,3248,577,3825,"24"
"399","08031003901","Census Tract 39.01, Denver County, Colorado",3901,162,924,646,316,37,16,12,2113,269,2382,"19"
"400","08031003902","Census Tract 39.02, Denver County, Colorado",3902,327,700,566,481,119,28,44,2265,312,2577,"23"
"401","08031004002","Census Tract 40.02, Denver County, Colorado",4002,165,444,444,299,148,57,8,1565,140,1705,"23"
"402","08031004003","Census Tract 40.03, Denver County, Colorado",4003,182,486,590,611,290,45,107,2311,237,2548,"30"
"403","08031004004","Census Tract 40.04, Denver County, Colorado",4004,96,216,242,170,85,61,4,874,102,976,"25"
"404","08031004005","Census Tract 40.05, Denver County, Colorado",4005,178,442,494,167,193,64,45,1583,215,1798,"27"
"405","08031004006","Census Tract 40.06, Denver County, Colorado",4006,236,648,715,237,47,137,0,2020,343,2363,"21"
"406","08031004101","Census Tract 41.01, Denver County, Colorado",4101,56,690,266,290,172,70,45,1589,69,1658,"25"
"407","08031004102","Census Tract 41.02, Denver County, Colorado",4102,180,405,444,328,237,89,71,1754,127,1881,"28"
"408","08031004103","Census Tract 41.03, Denver County, Colorado",4103,168,893,762,538,214,64,44,2683,311,2994,"24"
"409","08031004104","Census Tract 41.04, Denver County, Colorado",4104,120,651,791,498,151,125,59,2395,137,2532,"26"
"410","08031004106","Census Tract 41.06, Denver County, Colorado",4106,265,1258,1327,990,614,116,0,4570,518,5088,"25"
"411","08031004107","Census Tract 41.07, Denver County, Colorado",4107,204,714,1037,791,395,40,16,3197,390,3587,"25"
"412","08031004201","Census Tract 42.01, Denver County, Colorado",4201,126,943,503,338,276,60,11,2257,331,2588,"23"
"413","08031004202","Census Tract 42.02, Denver County, Colorado",4202,286,661,595,342,112,73,0,2069,281,2350,"21"
"414","08031004301","Census Tract 43.01, Denver County, Colorado",4301,355,1047,647,340,201,40,112,2742,245,2987,"23"
"415","08031004302","Census Tract 43.02, Denver County, Colorado",4302,173,417,323,214,147,70,0,1344,137,1481,"23"
"416","08031004303","Census Tract 43.03, Denver County, Colorado",4303,227,387,593,189,105,29,7,1537,298,1835,"21"
"417","08031004304","Census Tract 43.04, Denver County, Colorado",4304,181,855,995,589,299,178,0,3097,307,3404,"25"
"418","08031004306","Census Tract 43.06, Denver County, Colorado",4306,221,678,845,532,180,43,42,2541,119,2660,"25"
"419","08031004403","Census Tract 44.03, Denver County, Colorado",4403,246,537,636,628,259,37,86,2429,114,2543,"27"
"420","08031004404","Census Tract 44.04, Denver County, Colorado",4404,203,463,768,778,403,215,23,2853,60,2913,"29"
"421","08031004405","Census Tract 44.05, Denver County, Colorado",4405,255,1275,1094,814,355,223,52,4068,309,4377,"25"
"422","08031004503","Census Tract 45.03, Denver County, Colorado",4503,32,210,272,445,412,82,17,1470,93,1563,"32"
"423","08031004504","Census Tract 45.04, Denver County, Colorado",4504,142,424,469,464,267,110,39,1915,50,1965,"28"
"424","08031004505","Census Tract 45.05, Denver County, Colorado",4505,128,387,348,669,199,178,8,1917,39,1956,"28"
"425","08031004506","Census Tract 45.06, Denver County, Colorado",4506,101,485,188,238,169,108,24,1313,48,1361,"26"
"426","08031004601","Census Tract 46.01, Denver County, Colorado",4601,220,692,460,592,356,45,18,2383,63,2446,"25"
"427","08031004602","Census Tract 46.02, Denver County, Colorado",4602,195,829,490,1099,609,314,116,3652,20,3672,"31"
"428","08031004603","Census Tract 46.03, Denver County, Colorado",4603,198,442,653,708,423,118,67,2609,109,2718,"29"
"429","08031004700","Census Tract 47, Denver County, Colorado",4700,180,742,820,893,299,90,127,3151,251,3402,"28"
"430","08031004801","Census Tract 48.01, Denver County, Colorado",4801,143,508,239,250,294,0,16,1450,17,1467,"26"
"431","08031005001","Census Tract 50.01, Denver County, Colorado",5001,88,383,333,281,208,18,15,1326,144,1470,"26"
"432","08031005002","Census Tract 50.02, Denver County, Colorado",5002,363,760,836,617,259,234,48,3117,190,3307,"26"
"433","08031005102","Census Tract 51.02, Denver County, Colorado",5102,214,375,559,320,149,72,40,1729,183,1912,"25"
"434","08031005104","Census Tract 51.04, Denver County, Colorado",5104,265,336,332,399,159,116,20,1627,96,1723,"25"
"435","08031005200","Census Tract 52, Denver County, Colorado",5200,240,417,442,222,177,35,0,1533,224,1757,"22"
"436","08031005300","Census Tract 53, Denver County, Colorado",5300,67,201,90,137,45,6,0,546,31,577,"21"
"437","08031005502","Census Tract 55.02, Denver County, Colorado",5502,98,198,203,172,131,37,5,844,61,905,"26"
"438","08031005503","Census Tract 55.03, Denver County, Colorado",5503,233,570,455,451,410,91,84,2294,214,2508,"29"
"439","08031006701","Census Tract 67.01, Denver County, Colorado",6701,249,985,725,283,150,15,9,2416,96,2512,"19"
"440","08031006804","Census Tract 68.04, Denver County, Colorado",6804,274,384,188,312,125,52,0,1335,81,1416,"22"
"441","08031006809","Census Tract 68.09, Denver County, Colorado",6809,321,1307,1313,562,125,15,0,3643,227,3870,"19"
"442","08031006810","Census Tract 68.10, Denver County, Colorado",6810,306,775,1094,726,236,95,16,3248,186,3434,"23"
"443","08031006811","Census Tract 68.11, Denver County, Colorado",6811,216,969,862,777,291,111,30,3256,254,3510,"25"
"444","08031006812","Census Tract 68.12, Denver County, Colorado",6812,123,577,610,358,132,23,0,1823,157,1980,"22"
"445","08031006813","Census Tract 68.13, Denver County, Colorado",6813,312,577,641,483,206,149,0,2368,66,2434,"24"
"446","08031006814","Census Tract 68.14, Denver County, Colorado",6814,185,808,434,646,211,125,33,2442,129,2571,"26"
"447","08031006901","Census Tract 69.01, Denver County, Colorado",6901,159,989,836,416,263,119,114,2896,63,2959,"26"
"448","08031007006","Census Tract 70.06, Denver County, Colorado",7006,130,692,755,716,237,139,78,2747,60,2807,"28"
"449","08031007013","Census Tract 70.13, Denver County, Colorado",7013,87,491,831,359,188,67,43,2066,222,2288,"26"
"450","08031007037","Census Tract 70.37, Denver County, Colorado",7037,169,574,636,572,196,119,94,2360,82,2442,"28"
"451","08031007088","Census Tract 70.88, Denver County, Colorado",7088,0,930,849,457,149,14,94,2493,202,2695,"25"
"452","08031007089","Census Tract 70.89, Denver County, Colorado",7089,107,348,401,442,216,79,28,1621,37,1658,"28"
"453","08031008304","Census Tract 83.04, Denver County, Colorado",8304,165,498,290,294,162,37,33,1479,45,1524,"25"
"454","08031008305","Census Tract 83.05, Denver County, Colorado",8305,0,373,302,484,314,72,107,1652,71,1723,"34"
"455","08031008306","Census Tract 83.06, Denver County, Colorado",8306,174,556,504,461,276,168,130,2269,52,2321,"31"
"456","08031008312","Census Tract 83.12, Denver County, Colorado",8312,336,912,843,762,327,145,35,3360,90,3450,"25"
"457","08031008386","Census Tract 83.86, Denver County, Colorado",8386,145,480,545,494,144,79,53,1940,40,1980,"27"
"458","08031008387","Census Tract 83.87, Denver County, Colorado",8387,135,892,510,744,303,165,65,2814,8,2822,"27"
"459","08031008388","Census Tract 83.88, Denver County, Colorado",8388,383,1256,663,1171,484,274,88,4319,192,4511,"26"
"460","08031008389","Census Tract 83.89, Denver County, Colorado",8389,343,916,1094,1070,1255,135,220,5033,111,5144,"33"
"461","08031008390","Census Tract 83.90, Denver County, Colorado",8390,131,1145,1063,994,696,212,262,4503,174,4677,"31"
"462","08031008391","Census Tract 83.91, Denver County, Colorado",8391,295,753,960,372,970,433,268,4051,47,4098,"36"
"463","08031011902","Census Tract 119.02, Denver County, Colorado",11902,104,977,744,883,471,139,159,3477,60,3537,"29"
"464","08031011903","Census Tract 119.03, Denver County, Colorado",11903,26,212,309,302,169,23,14,1055,38,1093,"29"
"465","08031012001","Census Tract 120.01, Denver County, Colorado",12001,113,102,177,245,125,45,39,846,104,950,"30"
"466","08031012010","Census Tract 120.10, Denver County, Colorado",12010,132,556,477,404,588,208,36,2401,176,2577,"31"
"467","08031012014","Census Tract 120.14, Denver County, Colorado",12014,497,928,857,805,569,137,35,3828,73,3901,"25"
"468","08031015300","Census Tract 153, Denver County, Colorado",15300,336,456,932,348,319,106,14,2511,62,2573,"24"
"469","08031015400","Census Tract 154, Denver County, Colorado",15400,174,718,468,454,338,67,0,2219,189,2408,"24"
"470","08031015500","Census Tract 155, Denver County, Colorado",15500,120,562,546,363,287,209,32,2119,155,2274,"29"
"471","08031015600","Census Tract 156, Denver County, Colorado",15600,40,408,476,942,372,199,162,2599,101,2700,"34"
"472","08031015700","Census Tract 157, Denver County, Colorado",15700,171,601,505,590,448,133,28,2476,67,2543,"28"
"473","08031980000","Census Tract 9800, Denver County, Colorado",980000,22,165,134,185,156,13,23,698,23,721,"31"
"474","08031980100","Census Tract 9801, Denver County, Colorado",980100,0,0,0,0,0,0,0,0,0,0,NA
"475","08035013901","Census Tract 139.01, Douglas County, Colorado",13901,365,759,1001,947,499,174,32,3777,196,3973,"26"
"476","08035013904","Census Tract 139.04, Douglas County, Colorado",13904,429,566,319,408,348,101,30,2201,96,2297,"25"
"477","08035013905","Census Tract 139.05, Douglas County, Colorado",13905,316,294,308,398,229,95,54,1694,166,1860,"28"
"478","08035013907","Census Tract 139.07, Douglas County, Colorado",13907,243,488,543,688,213,103,4,2282,234,2516,"25"
"479","08035013908","Census Tract 139.08, Douglas County, Colorado",13908,100,575,935,728,818,303,26,3485,511,3996,"31"
"480","08035013909","Census Tract 139.09, Douglas County, Colorado",13909,129,488,664,766,835,127,42,3051,428,3479,"31"
"481","08035013910","Census Tract 139.10, Douglas County, Colorado",13910,177,751,585,687,654,126,38,3018,179,3197,"29"
"482","08035013911","Census Tract 139.11, Douglas County, Colorado",13911,181,651,752,626,621,181,65,3077,392,3469,"30"
"483","08035014001","Census Tract 140.01, Douglas County, Colorado",14001,331,1099,731,825,435,177,155,3753,220,3973,"29"
"484","08035014005","Census Tract 140.05, Douglas County, Colorado",14005,219,676,511,465,343,108,6,2328,174,2502,"25"
"485","08035014006","Census Tract 140.06, Douglas County, Colorado",14006,156,836,683,382,538,157,84,2836,386,3222,"29"
"486","08035014007","Census Tract 140.07, Douglas County, Colorado",14007,342,533,257,240,299,12,11,1694,267,1961,"21"
"487","08035014008","Census Tract 140.08, Douglas County, Colorado",14008,254,973,771,568,395,152,26,3139,522,3661,"26"
"488","08035014009","Census Tract 140.09, Douglas County, Colorado",14009,268,362,424,362,354,53,35,1858,160,2018,"27"
"489","08035014010","Census Tract 140.10, Douglas County, Colorado",14010,291,1277,518,460,376,78,13,3013,249,3262,"22"
"490","08035014011","Census Tract 140.11, Douglas County, Colorado",14011,152,339,297,168,159,56,0,1171,169,1340,"23"
"491","08035014012","Census Tract 140.12, Douglas County, Colorado",14012,171,630,726,672,843,145,59,3246,417,3663,"30"
"492","08035014013","Census Tract 140.13, Douglas County, Colorado",14013,71,332,432,491,580,90,6,2002,419,2421,"31"
"493","08035014107","Census Tract 141.07, Douglas County, Colorado",14107,292,480,291,258,301,100,35,1757,203,1960,"27"
"494","08035014108","Census Tract 141.08, Douglas County, Colorado",14108,326,742,537,357,275,179,14,2430,156,2586,"24"
"495","08035014109","Census Tract 141.09, Douglas County, Colorado",14109,109,370,303,159,102,99,6,1148,108,1256,"25"
"496","08035014110","Census Tract 141.10, Douglas County, Colorado",14110,222,772,575,364,365,67,59,2424,391,2815,"26"
"497","08035014112","Census Tract 141.12, Douglas County, Colorado",14112,162,777,401,199,240,74,0,1853,133,1986,"23"
"498","08035014113","Census Tract 141.13, Douglas County, Colorado",14113,172,497,247,375,156,60,15,1522,213,1735,"24"
"499","08035014114","Census Tract 141.14, Douglas County, Colorado",14114,378,773,471,156,133,96,0,2007,150,2157,"19"
"500","08035014115","Census Tract 141.15, Douglas County, Colorado",14115,264,678,280,261,266,63,25,1837,261,2098,"24"
"501","08035014116","Census Tract 141.16, Douglas County, Colorado",14116,400,1338,466,509,356,77,52,3198,249,3447,"23"
"502","08035014122","Census Tract 141.22, Douglas County, Colorado",14122,224,667,814,468,381,143,15,2712,631,3343,"26"
"503","08035014123","Census Tract 141.23, Douglas County, Colorado",14123,110,362,299,178,225,120,0,1294,95,1389,"27"
"504","08035014124","Census Tract 141.24, Douglas County, Colorado",14124,247,543,694,706,469,119,78,2856,308,3164,"30"
"505","08035014125","Census Tract 141.25, Douglas County, Colorado",14125,179,559,337,161,308,176,18,1738,221,1959,"28"
"506","08035014126","Census Tract 141.26, Douglas County, Colorado",14126,97,228,297,141,116,115,24,1018,76,1094,"30"
"507","08035014127","Census Tract 141.27, Douglas County, Colorado",14127,74,377,681,433,313,64,40,1982,410,2392,"28"
"508","08035014128","Census Tract 141.28, Douglas County, Colorado",14128,297,627,679,428,348,80,66,2525,312,2837,"26"
"509","08035014129","Census Tract 141.29, Douglas County, Colorado",14129,183,405,426,365,161,121,37,1698,288,1986,"28"
"510","08035014130","Census Tract 141.30, Douglas County, Colorado",14130,546,871,951,633,668,243,41,3953,249,4202,"27"
"511","08035014131","Census Tract 141.31, Douglas County, Colorado",14131,268,529,356,167,181,52,0,1553,212,1765,"21"
"512","08035014132","Census Tract 141.32, Douglas County, Colorado",14132,182,632,708,497,290,157,95,2561,437,2998,"29"
"513","08035014133","Census Tract 141.33, Douglas County, Colorado",14133,230,826,684,781,404,83,56,3064,685,3749,"26"
"514","08035014134","Census Tract 141.34, Douglas County, Colorado",14134,251,645,845,463,340,205,7,2756,595,3351,"26"
"515","08035014135","Census Tract 141.35, Douglas County, Colorado",14135,122,350,297,185,221,27,5,1207,361,1568,"24"
"516","08035014136","Census Tract 141.36, Douglas County, Colorado",14136,469,1116,1147,838,763,236,54,4623,311,4934,"27"
"517","08035014137","Census Tract 141.37, Douglas County, Colorado",14137,227,1610,1173,577,553,119,108,4367,536,4903,"25"
"518","08035014138","Census Tract 141.38, Douglas County, Colorado",14138,50,992,450,343,157,101,9,2102,215,2317,"23"
"519","08035014139","Census Tract 141.39, Douglas County, Colorado",14139,111,592,400,426,235,63,15,1842,123,1965,"26"
"520","08035014140","Census Tract 141.40, Douglas County, Colorado",14140,227,701,526,351,275,183,9,2272,382,2654,"25"
"521","08035014202","Census Tract 142.02, Douglas County, Colorado",14202,46,151,114,209,153,88,41,802,161,963,"34"
"522","08035014203","Census Tract 142.03, Douglas County, Colorado",14203,161,377,509,549,1040,382,12,3030,587,3617,"34"
"523","08035014204","Census Tract 142.04, Douglas County, Colorado",14204,146,210,388,423,272,209,49,1697,182,1879,"34"
"524","08035014300","Census Tract 143, Douglas County, Colorado",14300,16,34,78,18,126,25,25,322,31,353,"42"
"525","08035014403","Census Tract 144.03, Douglas County, Colorado",14403,177,265,537,545,532,193,17,2266,370,2636,"31"
"526","08035014404","Census Tract 144.04, Douglas County, Colorado",14404,49,93,225,201,287,213,60,1128,221,1349,"42"
"527","08035014405","Census Tract 144.05, Douglas County, Colorado",14405,414,786,705,806,495,331,40,3577,431,4008,"28"
"528","08035014406","Census Tract 144.06, Douglas County, Colorado",14406,530,801,929,902,1063,232,196,4653,526,5179,"33"
"529","08035014503","Census Tract 145.03, Douglas County, Colorado",14503,577,365,424,493,524,210,87,2680,299,2979,"29"
"530","08035014504","Census Tract 145.04, Douglas County, Colorado",14504,378,506,409,506,280,92,31,2202,124,2326,"24"
"531","08035014505","Census Tract 145.05, Douglas County, Colorado",14505,330,627,335,571,397,168,29,2457,310,2767,"27"
"532","08035014506","Census Tract 145.06, Douglas County, Colorado",14506,117,351,315,324,398,194,70,1769,289,2058,"35"
"533","08035014602","Census Tract 146.02, Douglas County, Colorado",14602,71,63,239,175,433,120,32,1133,210,1343,"39"
"534","08035014603","Census Tract 146.03, Douglas County, Colorado",14603,244,1161,637,469,719,291,18,3539,208,3747,"27"
"535","08035014604","Census Tract 146.04, Douglas County, Colorado",14604,170,378,292,436,421,153,15,1865,138,2003,"30"
"536","08059009806","Census Tract 98.06, Jefferson County, Colorado",9806,185,552,330,294,257,43,30,1691,126,1817,"26"
"537","08059009807","Census Tract 98.07, Jefferson County, Colorado",9807,109,229,168,165,102,21,0,794,57,851,"23"
"538","08059009808","Census Tract 98.08, Jefferson County, Colorado",9808,339,475,568,741,592,290,89,3094,261,3355,"32"
"539","08059009815","Census Tract 98.15, Jefferson County, Colorado",9815,167,576,629,440,415,162,18,2407,253,2660,"27"
"540","08059009823","Census Tract 98.23, Jefferson County, Colorado",9823,157,619,410,759,372,148,82,2547,274,2821,"31"
"541","08059009824","Census Tract 98.24, Jefferson County, Colorado",9824,258,807,737,691,264,117,47,2921,177,3098,"25"
"542","08059009827","Census Tract 98.27, Jefferson County, Colorado",9827,114,1003,870,687,519,82,11,3286,215,3501,"26"
"543","08059009828","Census Tract 98.28, Jefferson County, Colorado",9828,135,594,742,701,363,79,38,2652,171,2823,"28"
"544","08059009829","Census Tract 98.29, Jefferson County, Colorado",9829,96,308,278,208,155,12,6,1063,65,1128,"24"
"545","08059009830","Census Tract 98.30, Jefferson County, Colorado",9830,74,260,316,228,222,74,15,1189,22,1211,"29"
"546","08059009831","Census Tract 98.31, Jefferson County, Colorado",9831,258,485,540,248,216,70,11,1828,49,1877,"22"
"547","08059009832","Census Tract 98.32, Jefferson County, Colorado",9832,110,344,380,246,118,62,39,1299,135,1434,"28"
"548","08059009833","Census Tract 98.33, Jefferson County, Colorado",9833,356,469,594,710,336,271,15,2751,185,2936,"28"
"549","08059009834","Census Tract 98.34, Jefferson County, Colorado",9834,127,359,703,617,409,94,68,2377,142,2519,"30"
"550","08059009835","Census Tract 98.35, Jefferson County, Colorado",9835,151,255,493,529,253,61,14,1756,229,1985,"27"
"551","08059009836","Census Tract 98.36, Jefferson County, Colorado",9836,90,411,501,473,303,107,49,1934,210,2144,"30"
"552","08059009837","Census Tract 98.37, Jefferson County, Colorado",9837,131,376,474,242,295,42,24,1584,273,1857,"27"
"553","08059009838","Census Tract 98.38, Jefferson County, Colorado",9838,187,511,592,440,431,160,72,2393,266,2659,"32"
"554","08059009839","Census Tract 98.39, Jefferson County, Colorado",9839,152,316,262,226,218,63,12,1249,77,1326,"26"
"555","08059009840","Census Tract 98.40, Jefferson County, Colorado",9840,108,614,360,378,303,118,64,1945,87,2032,"28"
"556","08059009841","Census Tract 98.41, Jefferson County, Colorado",9841,241,277,266,209,210,46,7,1256,69,1325,"25"
"557","08059009842","Census Tract 98.42, Jefferson County, Colorado",9842,42,305,488,193,169,95,58,1350,141,1491,"31"
"558","08059009843","Census Tract 98.43, Jefferson County, Colorado",9843,408,892,761,981,575,190,29,3836,385,4221,"27"
"559","08059009845","Census Tract 98.45, Jefferson County, Colorado",9845,162,238,352,446,333,96,0,1627,378,2005,"29"
"560","08059009846","Census Tract 98.46, Jefferson County, Colorado",9846,281,287,270,325,404,56,9,1632,495,2127,"27"
"561","08059009847","Census Tract 98.47, Jefferson County, Colorado",9847,245,187,160,244,298,195,0,1329,253,1582,"30"
"562","08059009848","Census Tract 98.48, Jefferson County, Colorado",9848,111,111,124,152,209,74,10,791,181,972,"32"
"563","08059009849","Census Tract 98.49, Jefferson County, Colorado",9849,519,892,601,371,336,66,41,2826,282,3108,"22"
"564","08059009850","Census Tract 98.50, Jefferson County, Colorado",9850,136,228,300,207,304,55,0,1230,246,1476,"28"
"565","08059009851","Census Tract 98.51, Jefferson County, Colorado",9851,125,358,410,508,240,69,31,1741,169,1910,"28"
"566","08059009852","Census Tract 98.52, Jefferson County, Colorado",9852,234,597,430,212,98,134,42,1747,135,1882,"24"
"567","08059009900","Census Tract 99, Jefferson County, Colorado",9900,180,362,267,192,98,25,0,1124,135,1259,"20"
"568","08059010000","Census Tract 100, Jefferson County, Colorado",10000,393,598,370,251,142,51,8,1813,209,2022,"20"
"569","08059010100","Census Tract 101, Jefferson County, Colorado",10100,318,774,569,343,397,112,47,2560,112,2672,"27"
"570","08059010205","Census Tract 102.05, Jefferson County, Colorado",10205,62,275,258,210,142,54,20,1021,108,1129,"27"
"571","08059010206","Census Tract 102.06, Jefferson County, Colorado",10206,188,392,549,574,283,107,80,2173,125,2298,"31"
"572","08059010208","Census Tract 102.08, Jefferson County, Colorado",10208,172,514,891,647,319,193,88,2824,132,2956,"29"
"573","08059010209","Census Tract 102.09, Jefferson County, Colorado",10209,101,808,840,678,525,250,74,3276,172,3448,"31"
"574","08059010210","Census Tract 102.10, Jefferson County, Colorado",10210,154,360,450,384,217,167,24,1756,128,1884,"28"
"575","08059010211","Census Tract 102.11, Jefferson County, Colorado",10211,155,411,338,246,216,65,96,1527,93,1620,"33"
"576","08059010212","Census Tract 102.12, Jefferson County, Colorado",10212,274,610,594,416,347,58,49,2348,78,2426,"25"
"577","08059010213","Census Tract 102.13, Jefferson County, Colorado",10213,217,507,745,596,321,64,22,2472,110,2582,"26"
"578","08059010303","Census Tract 103.03, Jefferson County, Colorado",10303,135,921,725,507,255,67,37,2647,230,2877,"24"
"579","08059010304","Census Tract 103.04, Jefferson County, Colorado",10304,41,453,229,327,153,105,6,1314,101,1415,"27"
"580","08059010305","Census Tract 103.05, Jefferson County, Colorado",10305,144,640,552,413,225,39,27,2040,175,2215,"24"
"581","08059010306","Census Tract 103.06, Jefferson County, Colorado",10306,117,454,239,305,181,80,30,1406,129,1535,"26"
"582","08059010307","Census Tract 103.07, Jefferson County, Colorado",10307,326,608,649,445,228,133,0,2389,154,2543,"24"
"583","08059010308","Census Tract 103.08, Jefferson County, Colorado",10308,261,1225,789,452,604,159,17,3507,127,3634,"25"
"584","08059010402","Census Tract 104.02, Jefferson County, Colorado",10402,206,649,839,380,354,305,0,2733,83,2816,"27"
"585","08059010403","Census Tract 104.03, Jefferson County, Colorado",10403,292,981,578,584,269,15,26,2745,84,2829,"22"
"586","08059010405","Census Tract 104.05, Jefferson County, Colorado",10405,165,299,318,318,199,0,51,1350,55,1405,"27"
"587","08059010406","Census Tract 104.06, Jefferson County, Colorado",10406,100,415,370,270,72,46,51,1324,32,1356,"26"
"588","08059010502","Census Tract 105.02, Jefferson County, Colorado",10502,329,676,616,498,290,120,41,2570,92,2662,"24"
"589","08059010503","Census Tract 105.03, Jefferson County, Colorado",10503,314,687,323,393,159,108,9,1993,166,2159,"22"
"590","08059010504","Census Tract 105.04, Jefferson County, Colorado",10504,158,439,318,223,160,33,0,1331,145,1476,"22"
"591","08059010603","Census Tract 106.03, Jefferson County, Colorado",10603,152,444,523,383,142,116,55,1815,177,1992,"26"
"592","08059010604","Census Tract 106.04, Jefferson County, Colorado",10604,201,241,245,260,68,22,0,1037,38,1075,"21"
"593","08059010701","Census Tract 107.01, Jefferson County, Colorado",10701,184,627,546,275,267,52,44,1995,145,2140,"24"
"594","08059010702","Census Tract 107.02, Jefferson County, Colorado",10702,222,850,848,384,300,68,0,2672,147,2819,"22"
"595","08059010801","Census Tract 108.01, Jefferson County, Colorado",10801,167,254,245,74,182,52,46,1020,115,1135,"27"
"596","08059010901","Census Tract 109.01, Jefferson County, Colorado",10901,369,472,550,265,497,63,0,2216,116,2332,"25"
"597","08059010902","Census Tract 109.02, Jefferson County, Colorado",10902,165,620,291,165,186,53,35,1515,45,1560,"24"
"598","08059011000","Census Tract 110, Jefferson County, Colorado",11000,388,880,775,393,253,199,123,3011,100,3111,"26"
"599","08059011100","Census Tract 111, Jefferson County, Colorado",11100,274,798,549,450,445,162,33,2711,167,2878,"26"
"600","08059011202","Census Tract 112.02, Jefferson County, Colorado",11202,263,546,548,447,281,37,7,2129,327,2456,"24"
"601","08059011300","Census Tract 113, Jefferson County, Colorado",11300,94,487,361,247,159,47,0,1395,71,1466,"23"
"602","08059011401","Census Tract 114.01, Jefferson County, Colorado",11401,51,240,384,391,161,135,51,1413,39,1452,"31"
"603","08059011402","Census Tract 114.02, Jefferson County, Colorado",11402,127,595,405,317,212,53,47,1756,143,1899,"25"
"604","08059011550","Census Tract 115.50, Jefferson County, Colorado",11550,112,843,645,654,414,103,48,2819,65,2884,"27"
"605","08059011601","Census Tract 116.01, Jefferson County, Colorado",11601,101,556,366,344,289,126,33,1815,28,1843,"27"
"606","08059011602","Census Tract 116.02, Jefferson County, Colorado",11602,211,556,424,554,150,72,16,1983,109,2092,"24"
"607","08059011701","Census Tract 117.01, Jefferson County, Colorado",11701,337,564,537,459,269,155,17,2338,226,2564,"25"
"608","08059011702","Census Tract 117.02, Jefferson County, Colorado",11702,151,899,719,548,485,163,17,2982,158,3140,"26"
"609","08059011708","Census Tract 117.08, Jefferson County, Colorado",11708,245,405,362,425,228,97,21,1783,76,1859,"25"
"610","08059011709","Census Tract 117.09, Jefferson County, Colorado",11709,73,480,278,371,391,88,19,1700,145,1845,"30"
"611","08059011710","Census Tract 117.10, Jefferson County, Colorado",11710,250,607,444,321,199,86,20,1927,132,2059,"24"
"612","08059011711","Census Tract 117.11, Jefferson County, Colorado",11711,161,689,378,568,214,140,40,2190,151,2341,"28"
"613","08059011712","Census Tract 117.12, Jefferson County, Colorado",11712,163,597,464,303,346,53,31,1957,238,2195,"26"
"614","08059011720","Census Tract 117.20, Jefferson County, Colorado",11720,321,667,437,394,332,93,97,2341,174,2515,"29"
"615","08059011721","Census Tract 117.21, Jefferson County, Colorado",11721,117,484,263,298,195,45,0,1402,124,1526,"24"
"616","08059011723","Census Tract 117.23, Jefferson County, Colorado",11723,286,415,452,430,225,43,0,1851,96,1947,"23"
"617","08059011724","Census Tract 117.24, Jefferson County, Colorado",11724,203,1064,404,398,565,48,6,2688,336,3024,"24"
"618","08059011725","Census Tract 117.25, Jefferson County, Colorado",11725,61,278,226,128,130,69,14,906,50,956,"26"
"619","08059011726","Census Tract 117.26, Jefferson County, Colorado",11726,311,952,416,515,528,184,26,2932,271,3203,"26"
"620","08059011727","Census Tract 117.27, Jefferson County, Colorado",11727,101,528,486,281,220,30,21,1667,153,1820,"24"
"621","08059011728","Census Tract 117.28, Jefferson County, Colorado",11728,49,277,329,208,193,80,26,1162,83,1245,"28"
"622","08059011729","Census Tract 117.29, Jefferson County, Colorado",11729,130,629,615,439,395,77,17,2302,121,2423,"27"
"623","08059011730","Census Tract 117.30, Jefferson County, Colorado",11730,194,472,422,417,206,160,76,1947,41,1988,"30"
"624","08059011731","Census Tract 117.31, Jefferson County, Colorado",11731,234,745,559,477,251,92,60,2418,84,2502,"27"
"625","08059011732","Census Tract 117.32, Jefferson County, Colorado",11732,402,811,630,261,638,184,150,3076,70,3146,"30"
"626","08059011733","Census Tract 117.33, Jefferson County, Colorado",11733,73,229,175,127,85,31,0,720,40,760,"23"
"627","08059011803","Census Tract 118.03, Jefferson County, Colorado",11803,176,759,511,779,478,220,24,2947,94,3041,"28"
"628","08059011804","Census Tract 118.04, Jefferson County, Colorado",11804,191,476,484,583,148,162,20,2064,40,2104,"26"
"629","08059011805","Census Tract 118.05, Jefferson County, Colorado",11805,341,1319,694,651,359,87,84,3535,29,3564,"24"
"630","08059011806","Census Tract 118.06, Jefferson County, Colorado",11806,180,599,413,576,229,243,0,2240,100,2340,"27"
"631","08059011904","Census Tract 119.04, Jefferson County, Colorado",11904,72,303,266,164,137,55,46,1043,92,1135,"29"
"632","08059011951","Census Tract 119.51, Jefferson County, Colorado",11951,56,604,254,341,267,83,63,1668,60,1728,"29"
"633","08059012022","Census Tract 120.22, Jefferson County, Colorado",12022,332,606,726,566,502,79,41,2852,380,3232,"26"
"634","08059012023","Census Tract 120.23, Jefferson County, Colorado",12023,125,343,454,443,212,92,28,1697,115,1812,"29"
"635","08059012024","Census Tract 120.24, Jefferson County, Colorado",12024,300,405,596,391,570,54,70,2386,303,2689,"28"
"636","08059012026","Census Tract 120.26, Jefferson County, Colorado",12026,224,276,170,240,376,228,39,1553,287,1840,"32"
"637","08059012027","Census Tract 120.27, Jefferson County, Colorado",12027,46,165,346,315,336,212,4,1424,217,1641,"34"
"638","08059012030","Census Tract 120.30, Jefferson County, Colorado",12030,65,565,158,411,399,211,31,1840,434,2274,"32"
"639","08059012031","Census Tract 120.31, Jefferson County, Colorado",12031,227,170,255,372,454,179,83,1740,535,2275,"36"
"640","08059012032","Census Tract 120.32, Jefferson County, Colorado",12032,123,132,152,249,344,85,62,1147,149,1296,"38"
"641","08059012033","Census Tract 120.33, Jefferson County, Colorado",12033,66,75,152,436,395,128,14,1266,151,1417,"37"
"642","08059012034","Census Tract 120.34, Jefferson County, Colorado",12034,75,129,422,468,424,20,49,1587,309,1896,"34"
"643","08059012035","Census Tract 120.35, Jefferson County, Colorado",12035,136,350,555,489,435,214,14,2193,476,2669,"31"
"644","08059012036","Census Tract 120.36, Jefferson County, Colorado",12036,68,364,316,503,342,106,8,1707,277,1984,"30"
"645","08059012037","Census Tract 120.37, Jefferson County, Colorado",12037,153,182,104,309,619,215,71,1653,298,1951,"39"
"646","08059012038","Census Tract 120.38, Jefferson County, Colorado",12038,31,430,377,423,423,85,75,1844,202,2046,"34"
"647","08059012039","Census Tract 120.39, Jefferson County, Colorado",12039,200,660,735,647,714,80,52,3088,134,3222,"28"
"648","08059012041","Census Tract 120.41, Jefferson County, Colorado",12041,181,849,597,488,440,186,61,2802,164,2966,"28"
"649","08059012042","Census Tract 120.42, Jefferson County, Colorado",12042,167,547,530,318,450,84,11,2107,96,2203,"27"
"650","08059012043","Census Tract 120.43, Jefferson County, Colorado",12043,171,744,740,514,628,95,86,2978,218,3196,"30"
"651","08059012044","Census Tract 120.44, Jefferson County, Colorado",12044,204,436,551,364,548,76,74,2253,123,2376,"31"
"652","08059012045","Census Tract 120.45, Jefferson County, Colorado",12045,253,663,781,711,635,119,9,3171,189,3360,"27"
"653","08059012046","Census Tract 120.46, Jefferson County, Colorado",12046,117,188,199,200,211,129,5,1049,37,1086,"29"
"654","08059012047","Census Tract 120.47, Jefferson County, Colorado",12047,215,647,521,416,415,41,20,2275,93,2368,"25"
"655","08059012048","Census Tract 120.48, Jefferson County, Colorado",12048,90,227,203,212,171,24,6,933,93,1026,"25"
"656","08059012049","Census Tract 120.49, Jefferson County, Colorado",12049,49,547,387,430,457,108,7,1985,160,2145,"29"
"657","08059012050","Census Tract 120.50, Jefferson County, Colorado",12050,94,307,488,437,384,82,15,1807,158,1965,"29"
"658","08059012051","Census Tract 120.51, Jefferson County, Colorado",12051,94,288,229,404,207,90,19,1331,154,1485,"30"
"659","08059012052","Census Tract 120.52, Jefferson County, Colorado",12052,218,570,418,813,612,164,46,2841,210,3051,"30"
"660","08059012053","Census Tract 120.53, Jefferson County, Colorado",12053,188,620,312,379,317,169,70,2055,219,2274,"29"
"661","08059012054","Census Tract 120.54, Jefferson County, Colorado",12054,201,478,441,396,397,74,27,2014,98,2112,"27"
"662","08059012055","Census Tract 120.55, Jefferson County, Colorado",12055,145,311,483,417,241,69,0,1666,153,1819,"26"
"663","08059012057","Census Tract 120.57, Jefferson County, Colorado",12057,275,795,734,784,687,133,27,3435,173,3608,"28"
"664","08059012058","Census Tract 120.58, Jefferson County, Colorado",12058,67,236,195,388,636,373,63,1958,281,2239,"40"
"665","08059012059","Census Tract 120.59, Jefferson County, Colorado",12059,72,344,325,373,310,107,14,1545,148,1693,"29"
"666","08059012060","Census Tract 120.60, Jefferson County, Colorado",12060,118,587,259,306,333,81,22,1706,88,1794,"27"
"667","08059015800","Census Tract 158, Jefferson County, Colorado",15800,260,713,336,238,290,52,2,1891,66,1957,"22"
"668","08059015900","Census Tract 159, Jefferson County, Colorado",15900,176,280,468,217,290,136,0,1567,61,1628,"27"
"669","08059060300","Census Tract 603, Jefferson County, Colorado",60300,285,638,465,510,330,172,41,2441,197,2638,"28"
"670","08059060400","Census Tract 604, Jefferson County, Colorado",60400,296,275,410,476,328,103,26,1914,140,2054,"27"
"671","08059060500","Census Tract 605, Jefferson County, Colorado",60500,297,656,580,360,476,238,20,2627,239,2866,"27"
"672","08059980000","Census Tract 9800, Jefferson County, Colorado",980000,0,0,0,0,0,0,0,0,0,0,NA
"673","08059980400","Census Tract 9804, Jefferson County, Colorado",980400,0,0,0,0,0,0,0,0,0,0,NA
